1111111111
10E0000001
100C000001
1000000001
1C0000P001
1111111111
