1111111111111111111111111111111111111111
10000010000000000C0101001000001000010001
1010011101001001010010000010000101100101
1E10010010101010100100000101010001110101
100000000C1000C01010010000010000000000C1
100001010010010000100000C00C0000010000C1
1P01010010000001110000001001000010000C01
1000000001001000101010010000010000100001
100000000000000C001000101001000001000001
1010010100101001000001010100000101101101
1001001001010101010010100000101000110101
1010000000C00C000000101001010000010000C1
10000000001010010000010C0001C000000000C1
1010100000100100101001000001010001000C01
10000000000101001000001C00C00001000000C1
1010001101001000001000010010000101000C01
1000000000C000101001000001C00000000100C1
1000000010100100010100100000100000000101
1111111111111111111111111111111111111111