111111111111111111111111111111111111111111111111111111111111111111111111111111
10000001111110000000C000000000000000000000000000000000000100100001000C00000001
10100000000E000101011111101000001011010000000000000000100100001000C00000000001
101001001010101000000000011111100011010000001001000000000000001000C00000000001
1000000000000000000C00C000000001111110C000000001111000011111100000000000000001
1P0000000111100000000000000000000000011111111111100000100100001000C00000000001
100000000100100001000C00000000000000000000011111100000100000001000C00000000001
100000000100100001000000000000000000000001111000011111100000000001111110000001
1111001111111111111111100000100100001000C0000000000000011111100000000000000001
1000000000000000000000000C0000000000000000000000100100001000C11111100000000001
101001010010000000000000001011010000000000000000000111100001111110011111100001
111111101001001010101000110000000000010000001001000010000000000000C00000000001
100000011111100C00C000000000C0000000000000000001111000011111100000000000000001
100000000000011111100000011110000111111000001000000000000000001000C00000000001
1000000001001000000111111000000001000C0000000001111000011000000000011110000001
10000000010010000100000001111110000000000000100100001000C000000000000000000001
100000000000100101001000001011011111110000000001100000000001100001111110000001
10100100101000000000001010001101000001111110100100001000C000000000000000000001
1000000000000000000C000000000000C000000000C11111100000000111100001111110000001
111111100000000111100000000000000000000000011111100000000111100000000000000001
10000001111110000000000000000000000100100001000C000000100100001000C00000000001
100000000000011111100000000000000001001000010000000000000111100001111110000001
101001010010000010111111110000000000000000000001000000000100000001111110000001
101001001010101000110100011111100000011110000110000000000000000000011110000001
10000000000000000000000000000C00C000000000C00000111111100000001000C00000000001
100000000111100001111000000000011111100000000001100000000010000000001000000001
100000000100100001000C000000100100001111111000C0000000000000000000000000000001
100000000000000000000000000001001000010000011111100000000111100001111110000001
101001010010000010110000000000000000000001000000011111100100000001111110000001
101001001010101000110100000000011110000110000000000000011111100000011110000001
10000000000011111100000000000000000C00C000000000C00000100000001000C00000000001
100000000111100001111111111000000000000000000001100000000010000000001000000001
100000000100100001000C001111110000100100001000C0000000000000000000000000000001
100000000000000000000000000001001000010000000000000010000000001000000001111111
101001010010000010110000000000000000000001000000000111100001111110000011111101
111111100000000C00C000000000C0000000011110000110000000000000000000011110000001
100000011111100000000000000000000001111000011111100000100100001000C00000000001
10000000010011111110000100000000000000000000000C000000100100001000C00000000001
1000000001001000010111111000000000100100001000C0000000000000000000000000000001
111111111111111111111111111111111111111111111111111111111111111111111111111111