111111111111111111111111
100000000000000C00000001
101001010010000010110101
1E1001001010101000110101
101000000C00C0000000000011
101000000111100001111111
1P1000000100100001000C01
101000000100100001000001
111111111111111111111111