111111111111111111111111
100000000000000C00000001
101001010010000010110101
101001001010101000110101
101000000C00C000000000C1
101000000111100001111111
1P0000000100100001000E01
101000000100100001000001
111111111111111111111111