111111111111111111111111
1E0000000000000C00000001
101001010010000010110101
1010010010101010E0110101
100000000C00C000000000C1
1P0000000111100001111111
100000000100100001000C01
100000000100100001000001
111111111111111111111111