111111111111011111111111
1E0000000000000C00000001
101001010010000010110101
101001001010101000110101
1P0000000C00C000000000C1
111111111111111111111111